Argentina = Uruguay, Chile, Peru, Brazil
Chile = Argentina, Peru, Australia
Brazil = Uruguay, Peru, Argentina, Colombia, Sahara
Uruguay = Argentina, Brazil
Peru = Chile, Argentina, Brazil, Colombia
Colombia = Brazil, Peru, Mexico
Mexico = Colombia, California
California = Mexico, Oregon, NuevaYork
NuevaYork = California, Oregon, Canada, Terranova, Groenlandia
Oregon = Alaska, Yukon, Canada, California, NuevaYork
Alaska = Oregon, Yukon, Kamchatka
Canada = Yukon, Oregon, NuevaYork, Terranova
Terranova = NuevaYork, Canada, Labrador
Yukon = Alaska, Oregon, Canada
Labrador = Terranova, Groenlandia
Groenlandia = Labrador, NuevaYork, Islandia
Islandia = Groenlandia, Suecia, Gran Bretaña
Gran Bretaña = Islandia, Alemania, España
España = Gran Bretaña, Francia, Sahara
Francia = Alemania, Italia, España
Alemania = Italia, Francia, Gran Bretaña, Polonia
Italia = Francia, Alemania
Polonia = Egipto, Alemania, Rusia, Turquia
Rusia = Suecia, Polonia, Aral, Iran, Turquia
Suecia = Rusia, Islandia
Turquia = Polonia, Rusia, Iran, Israel, Arabia, Egipto
Israel = Egipto, Turquia, Arabia
Arabia = Israel, Turquia
Iran = Rusia, Turquia, China, Gobi, Mongolia, Aral, India
Aral = Rusia, Iran, Tartaria, Siberia, Mongolia
Tartaria = Aral, Taymir, Siberia
Taymir = Tartaria, Siberia
Siberia = Aral, Tartaria, Taymir, Kamchatka, China, Mongolia
Kamchatka = Siberia, China, Japon, Alaska
Japon = Kamchatka, China
Mongolia = Siberia, Aral, Iran, Gobi, China
China = Japon, Kamchatka, Siberia, Mongolia, Gobi, India, Malasia, Iran
Gobi = Mongolia, Iran, China
India = China, Malasia, Iran, Sumatra
Malasia = China, India, Borneo
Sahara = Egipto, Etiopia, Zaire, España, Brazil
Egipto = Sahara, Etiopia, Madagascar, Polonia, Turquia, Israel
Etiopia = Sahara, Egipto, Zaire, Sudafrica
Zaire = Sudafrica, Etiopia, Sahara, Madagascar
Sudafrica = Zaire, Etiopia
Madagascar = Egipto, Zaire
Australia = Java, Sumatra, Borneo, Chile
Sumatra = India, Australia
Borneo = Malasia, Australia
Java = Australia
